########################################
#................#######################
#.......a........#######################
#................#######################
#................#######################
###########............................#
#................###...................#
#.1...............F#.................@.D
#................###...................#
###########............................#
#................#######################
#................#######################
#.......a........#######################
#................#######################
########################################
