#####################
#.w...............w.#
#...................#
#...................#
#...................#
D.@.................#
#..............2....#
#...................#
#######......########
#..w..#.............#
#...................#
#...................#
#...........####..###
#...........#.......#
#.######....#.......#
#....2......#.......#
#...........#....1..#
#####################
