#################################################################
#........................#...............................#......#
#..............................................................2#
#........................#...............................########
#........................#............................2.........#
#........................###########............................#
#........................#.........#............................#
D.@......................#.1....................................#
#........................#.........#............................#
#........................###########............................#
#........................#................#######...............#
#........................#................#.....................#
#...............2.........................#.2...................#
#........................#................#.....................#
#################################################################
