################################################################1##################################################################
#........................................................#............#...........................................................#
#........................................................#............#...........................................................#
#........................................................#............#...........................................................#
#........................................................#............#...........................................................#
#........................................................#............#...........................................................#
#........................................................#............#...........................................................#
#........................................................#............#...........................................................#
#........................................................#............#...........................................................#
#........................................................#............#...........................................................#
#..............................###########################............###########################.................................#
#.................................................................................................................................#
#.................................................................................................................................#
#.........................#..........................................................................#............................#
#.........................#........#######################............#######################........#............................#
#.........................#........#b....................#............#....................b#........#............................#
#.........................#........#.....................#............#.....................#........#............................#
#.........................#........#.....................#............#.....................#........#............................#
#.........................#........#.....................#............#.....................#........#............................#
#.........................#........#.....................#............#.....................#........#............................#
#.........................#........#.....................#............#.....................#........#............................#
#.........................#........#.....................#............#.....................#........#............................#
#.........................#........#........................................................#........#............................#
#.........................#........#........................................................#........#............................#
###########################........##################......................##################........##############################
#.................................................................................................................................#
#.................................................................................................................................#
4...............................................................K.................................................................2
#.................................................................................................................................#
#.................................................................................................................................#
###########################........##################......................##################........##############################
#.........................#........#........................................................#........#............................#
#.........................#........#........................................................#........#............................#
#.........................#........#.....................#............#.....................#........#............................#
#.........................#........#.....................#............#.....................#........#............................#
#.........................#........#.....................#............#.....................#........#............................#
#.........................#........#.....................#............#.....................#........#............................#
#.........................#........#.....................#............#.....................#........#............................#
#.........................#........#.....................#............#.....................#........#............................#
#.........................#........#b....................#............#....................b#........#............................#
#.........................#........#######################............#######################........#............................#
#.........................#..........................................................................#............................#
#.................................................................................................................................#
#.................................................................................................................................#
#..............................###########################............###########################.................................#
#........................................................#............#...........................................................#
#........................................................#............#...........................................................#
#........................................................#............#...........................................................#
#........................................................#............#...........................................................#
#........................................................#............#...........................................................#
#........................................................#............#...........................................................#
#........................................................#............#...........................................................#
#........................................................#............#...........................................................#
#........................................................#............#...........................................................#
################################################################3##################################################################
