#########a#######
#1........#.....#
#.........#.....#
###.###.........#
#P....#...#.....#
###########..####
#p.............p#
#p.............p#
#p.2...........p#
#p...@.........p#
#####D###########
