#########################################
#......#......#...........#......#......#
#......#......#...........#......#......#
#......#......#...........#......#......#
###..#####..#######...#######..#####..###
#.......................................#
#..............####...####..............#
###..###.......#.........#.......###..###
#......#.........................#......#
#......#.......#.........#...@...#......#
#......#.......#.........#.......#......#
###########a#################D###########
