#########################################
#.........#.........#.....#.............#
#...................#.....#.............#
#.........................#.............#
#...1.....#...............#.............#
#.........#.........#.....#..############
#.........#.........#...................#
#####################..##################
#.........1.............................#
#...................#....1..............#
#.......................................#
####################D####################
