###################
#...b.b.b.b.b.#...#
#.............#...#
###########..##...#
#.................#
D@...............1#
#.................#
#########..########
#.................#
#.................#
#....s.s.s.s.s.s..#
###################
