#################################################################.....#############################################################################
#..........................................fffffffffffffffff......................................................................................#
#..........................................fcccccccccccccccf......................................................................................#
#..........................................fc              F......................................................................................#
#..........................................fc cccccccccccccf......................................................................................#
#..........................................fc cc            ......................................................................................#
#..........................................fc cc cccccc cccf......................................................................................#
#..........................................fc cc c#####(####......................................................................................#
#..........................................fc cc c##########......................................................................................#
#..........................................fc cc c##########......................................................................................#
#..........................................fc cc c##########......................................................................................#
#..........................................fffffff###4######......................................................................................#
#....................................................P...........................................##########.......................................#
#...............#####................................P...........................................##########.......................................#
#...............####pPPPPPPPPPPPPPPPPPPPPPPPPPPPPPPPPPPPPPPPPP...........PPPPPPPPPPPPPPPPPPPPPPPP5#########.......................................#
#...............#####........................................P...........P.......................##########.......................................#
#..................................#########fffffff..........PPPPPPPPPPPPP.......................##########.......................................#
#..................................#########      g................P..............................................................................#
#..................................#########fffffff................P.............................##########.......................................#
#..................................#########      g................P.............................##########.......................................#
#.........###########..............####2####fffffff................P.............................##########.......................................#
#.........###########..................P.....................###...P.............................##########.......................................#
#.........##########9PPPPPPPPPPPPPPPPPPP.....................#W#PPPP.............................####6#####.......................................#
#.........###########..................P.....................###...P.................................P............................................#
#.........###########..................PPPPPPPPP...................P.................................P............................................#
#.........###########..........................P............#######!#######............PPPPPPPPPPPPPPP............................................#
#.........###########..........................P............###############............P......................................##########..........#
..........###########..........................P............###############............P......................................##########...........
..........###########..........................P.........@..###############............P......................................##########...........
..........###########..........................PPPPPPPPPPPPP^######0######$PPPPPPPPPPPPPPPPPPPPPPPPPPPPPPPPPPPPPPPPPPPPPPPPPPP*#########...........
..........###########..........................P............###############.........................P.........................##########...........
..........###########..........................P............###############.........................P.........................##########...........
#.........###########..........................P............###############.........................P.........................##########..........#
#.........###########..........................P............#######%#######.........................P.........................##########..........#
#.........###########...................PPPPPPPP...................P...............#########........P.............................................#
#.........##########)PPPPPPPPPPPPPPPPPPPP..........................P...###.........#########........P.............................................#
#.........###########...................P..........................PPPP#W#.........########1PPPPPPPPP.............................................#
#.........###########...................P..........................P...###.........#########......................................................#
#.......................................P........................PPPPP.............#########......................................................#
#.......................................P........................P...P............................................................................#
#..................................#####7#####...................P...P.................................#############..............................#
#..................................###########...................P...P.................................#############..............................#
#..................................###########...................P...P....................PPPPPPPPPPPPPd############..............................#
#..................................###########...................P...P....................P............#############..............................#
#..................................###########...#########.......P...P....................P............#############..............................#
#................................................#########.......P...PPPPPPPPPPPPPPPPPPPPPP.......................................................#
#................................................########8PPPPPPPP................................................................................#
#................................................#########........................................................................................#
#................................................#########........................................................................................#
#.................................................................................................................................................#
#.................................................................................................................................................#
#.................................................................................................................................................#
#.................................................................................................................................................#
#.................................................................................................................................................#
#.................................................................................................................................................#
#.................................................................................................................................................#
#.................................................................................................................................................#
#.................................................................................................................................................#
#.................................................................................................................................................#
#.................................................................................................................................................#
#################################################################.....#############################################################################
