########################################
#................#######################
#M...............#######################
#................#######################
#................#######################
###########............................#
#.........#............................#
#.1..................................@.D
#.........#............................#
###########............................#
#................#######################
#................#######################
#M...............#######################
#................#######################
########################################
