###############################
######.............1#...Buy...#
######.............1#4........#
######.............1#.........#
######..............###########
#..................2#...Sell..#
D.@................2#5........#
#..................2#.........#
######..............###########
######.............3#.........#
######.............3#6........#
######.............3#.........#
###############################
